OOOOOOOOOOOOOOOOOOOO
OXXXXXXXXXXXXXXXXXXO
OXOOOOOOOOOOOOOOOOXO
OXOOOOOOOOOOOOOOOOXO
OXOOOOOXXXXOOOOOOOXO
OXOOOOOXXOOOOOOOOOXO
OXOOOOOOOOOOOOOOOOXO
OXOOOOOOOOOOOXXXXXXO
OXOOOOOOOOOOOOOOOOXO
OXOOOOOOOOOOOOOOOOXO
OXOOOXXOOOXOOOOOOOXO
OXOOOXXOOOOOOOOOOOXO
OXOOOOOOOOOOOOXXOOXO
OXOOOOOOOOOXXXXXOOXO
OXXXXXXXXXXXXXXXXXXO
OOOOOOOOOOOOOOOOOOOO