OOOOOOOOOOOOOOOOOOOO
OXXXXXXXXXXXXXXXXXXO
OXOOOOOOOOOOOOOOOOXO
OXOOOOOOOOOOOOOOOOXO
OXOOOOOXXOOOOOOOOOXO
OXOOOOOXXOOOOOOOOOXO
OXOOOOOOOOOOOOOOOOXO
OXOOOOOOOOOOOOOOOOXO
OXOOOOOOOOOOOOOOOOXO
OXOOOOOOOOOOOOOOOOXO
OXOOOXXOOOOOOOOOOOXO
OXOOOXXOOOOOOOOOOOXO
OXOOOOOOOOOOOOXXOOXO
OXOOOOOOOOOOOOXXOOXO
OXXXXXXXXXXXXXXXXXXO
OOOOOOOOOOOOOOOOOOOO