OOOOOOOOOO
OXXXXXXXXO
OXOOOOOOXO
OXOOOOOOXO
OXOOOOOOXO
OXOOOOOOXO
OXOOOOOOXO
OXOOOOOOXO
OXXXXXXXXO
OOOOOOOOOO